2,2,2,2,2,2,2,2,2,2,2,2,2,2,2,2,2,2,2
2,6,3,3,3,3,3,3,3,3,3,3,3,3,3,3,3,3,2
2,3,3,5,5,5,5,5,5,5,5,3,3,3,3,3,5,3,2
2,3,3,3,3,3,3,3,3,3,3,3,3,3,3,3,5,3,2
2,3,3,3,3,3,3,2,2,2,2,2,2,3,3,3,5,3,2
2,3,3,3,3,3,3,2,2,-1,2,2,5,5,3,3,5,3,2
2,3,3,3,3,3,3,2,2,3,2,2,5,5,3,3,3,3,2
2,3,3,3,3,3,3,3,3,3,3,3,3,3,3,3,3,3,2
2,3,3,3,3,3,3,3,3,3,3,3,3,3,3,3,3,3,2
2,3,3,3,3,3,3,2,2,2,3,3,3,3,2,2,2,3,2
2,3,3,3,3,3,3,3,3,3,5,5,5,5,7,3,2,3,2
2,3,2,2,2,3,3,2,2,2,3,3,3,3,2,4,2,3,2
2,3,2,2,3,5,5,3,3,3,3,3,3,3,2,2,2,3,2
2,3,3,3,3,3,3,3,3,3,3,3,3,3,3,3,3,3,2
2,2,2,2,2,2,2,2,2,2,2,2,2,2,2,2,2,2,2
1,1,1,1,1,1,1,1,1,1,1,1,1,1,1,1,1,1,1
