1,1,1,1,1,1,1,1,1,1,1,1,1,1,2,2,2,1,1
1,1,1,1,1,1,1,1,1,1,1,1,1,1,2,4,2,1,1
1,1,1,1,1,1,1,1,1,1,1,1,2,2,2,3,2,2,2
1,1,2,2,2,2,2,2,2,2,2,2,2,3,3,5,3,3,2
1,1,2,3,3,3,3,3,3,3,3,2,2,5,2,3,2,5,2
1,1,2,3,3,3,2,2,2,2,3,3,2,5,3,5,3,5,2
1,1,2,3,3,3,3,5,3,2,3,3,2,2,2,3,2,2,2
1,2,2,2,5,3,2,3,3,2,3,3,5,3,2,3,2,2,2
1,2,3,3,5,2,2,2,3,2,2,2,3,2,2,7,2,2,2
1,2,3,2,3,3,6,2,5,3,3,3,3,2,3,5,5,5,2
1,2,3,2,3,2,3,2,5,2,3,3,3,2,3,2,2,5,2
1,2,3,3,5,2,3,2,3,2,3,3,3,2,3,-1,2,5,2
1,2,2,2,3,3,5,5,3,2,3,3,3,2,2,2,2,5,2
1,1,1,2,3,3,2,3,3,2,3,3,5,5,5,5,5,5,2
1,1,1,2,2,2,2,2,2,2,2,2,2,2,2,2,2,2,2
1,1,1,1,1,1,1,1,1,1,1,1,1,1,1,1,1,1,1
